Level name: 
Sprite Set: Classic
Player Maximum: 4
Spawn 1: 1, 1
Spawn 2: 15, 1
Spawn 3: 1, 13
Spawn 4: 15, 13
Widht: 17
Heigth: 15
Structure:
55555555555555555
50044444444444005
50545454545454505
54444444444444445
54545454545454545
54444444444444445
54545450505454545
54444440004444445
54545450505454545
54444444444444445
54545454545454545
54444444444444445
50545454545454505
50044444444444005
55555555555555555
