Level name: 
Sprite Set: New
Player Maximum: 4
Spawn 1: 1, 1
Spawn 2: 17, 1
Spawn 3: 1, 11
Spawn 4: 17, 11
Widht: 19
Heigth: 13
Structure:
5555555555555555555
5004444444444444005
5054545454545454505
5444444444444444445
5454545454545454545
5444444400044444445
5454545450545454545
5444444400044444445
5454545454545454545
5444444444444444445
5054545454545454505
5004444444444444005
5555555555555555555
